"County","VBM Ballots issued","VBM Ballots accepted","Drop Box","Drop Off Location","Vote Center Drop Off","Mail","FAX","Other","Regular Ballots","Provisional Ballots  
(Non-CVR)","Conditional (CVR)","Conditional (""Instant"" CVR )","In Person Ballots accepted","TOTAL BALLOTS CAST","VBM ballots returned","In person ballots returned","VBM and In Person Ballots Returned","VBM and In Person Ballots Accepted","% VBM returned","% VBM accepted","% total accepted","Total Registered","% voted"
"Alameda",970950,192677,59869,764,75,133205,719,0,3299,0,0,0,3299,197931,194632,3299,197931,195976,20.05,19.84,20.12,961304,20.39
"Alpine",972,414,130,0,0,284,0,0,0,0,0,0,0,414,414,0,414,414,42.59,42.59,42.59,954,43.4
"Amador",26939,11877,6425,1,149,5301,24,0,181,0,1,22,203,12104,11900,204,12104,12080,44.17,44.09,44.51,26488,45.61
"Butte",125952,41432,13227,1134,777,26563,93,0,0,0,0,0,0,41794,41794,0,41794,41432,33.18,32.9,32.9,125088,33.12
"Calaveras",33555,11983,3825,993,340,6870,19,0,736,0,1,46,782,12830,12047,783,12830,12765,35.9,35.71,37.17,33059,38.61
"Colusa",10708,2810,904,299,0,1687,5,0,0,0,0,2,2,2897,2895,2,2897,2812,27.04,26.24,26.26,10626,26.46
"Contra Costa",730905,222306,82683,1279,0,140548,252,0,534,0,0,0,534,225296,224762,534,225296,222840,30.75,30.42,30.47,722861,30.83
"Del Norte",15252,4512,29,1981,0,2605,1,0,0,0,0,0,0,4616,4616,0,4616,4512,30.26,29.58,29.58,15036,30.01
"El Dorado",136756,50051,25001,0,910,24467,72,0,976,0,0,69,1045,51495,50450,1045,51495,51096,36.89,36.6,37.08,135300,37.76
"Fresno",522954,124929,47771,0,5922,73039,263,0,3943,0,0,161,4104,131099,126995,4104,131099,129033,24.28,23.89,24.48,513799,25.11
"Glenn",14105,4537,2074,172,0,2327,0,0,0,1,0,0,0,4574,4573,1,4574,4537,32.42,32.17,32.16,13834,32.8
"Humboldt",84661,21743,5572,1622,0,14691,61,0,872,0,24,0,873,22842,21946,896,22842,22616,25.92,25.68,26.43,84100,26.89
"Imperial",91897,15029,3954,713,0,10649,9,1,0,0,0,0,0,15326,15326,0,15326,15029,16.68,16.35,16.35,90086,16.68
"Inyo",11093,3923,980,100,0,2829,17,0,0,0,0,0,0,3926,3926,0,3926,3923,35.39,35.36,35.36,10807,36.3
"Kern",461637,101625,26401,7313,0,68636,122,0,0,0,0,0,0,102472,102472,0,102472,101625,22.2,22.01,22.01,458138,22.18
"Kings",65207,16381,8737,530,192,7179,19,0,347,0,6,69,416,17079,16657,422,17079,16797,25.54,25.12,25.59,64617,25.99
"Lake",38392,7841,949,606,0,6303,22,0,0,0,0,0,0,7880,7880,0,7880,7841,20.53,20.42,20.42,37975,20.65
"Lassen",15102,5255,1449,1213,0,2593,0,0,0,0,0,0,0,5255,5255,0,5255,5255,34.8,34.8,34.8,14992,35.05
"Los Angeles",5804783,1104795,500193,3503,29050,578975,2684,13,79021,90,1656,0,80735,1195185,1114418,80767,1195185,1185530,19.2,19.03,20.14,5745214,20.64
"Madera",78930,22191,9095,975,85,12124,28,0,353,0,29,11,393,22700,22307,393,22700,22584,28.26,28.11,28.47,78204,28.88
"Marin",174740,65930,10631,0,1158,54247,538,0,928,1,85,0,1013,67588,66574,1014,67588,66943,38.1,37.73,38.09,172385,38.83
"Mariposa",11993,5001,3233,6,0,1768,13,0,0,0,0,0,0,5020,5020,0,5020,5001,41.86,41.7,41.7,11739,42.6
"Mendocino",55098,18116,3789,3561,0,10730,97,0,0,0,0,0,0,18177,18177,0,18177,18116,32.99,32.88,32.88,54447,33.27
"Merced",134081,30606,9015,1407,0,21206,35,0,406,0,0,0,406,32069,31663,406,32069,31012,23.61,22.83,23.06,132007,23.49
"Modoc",5270,2063,409,496,0,1187,3,0,0,0,0,0,0,2095,2095,0,2095,2063,39.75,39.15,39.15,5191,39.74
"Mono",7889,2501,847,44,0,1623,12,0,0,0,0,0,0,2526,2526,0,2526,2501,32.02,31.7,31.7,7789,32.11
"Monterey",218450,64153,21539,1,0,43026,407,0,694,0,0,0,694,65667,64973,694,65667,64847,29.74,29.37,29.59,214883,30.18
"Napa",86183,28037,9431,2,1851,17316,98,0,336,0,65,1,358,29100,28698,402,29100,28395,33.3,32.53,32.79,85045,33.39
"Nevada",76721,27241,7438,5751,1767,12305,115,0,699,0,0,0,699,28075,27376,699,28075,27940,35.68,35.51,36.09,75654,36.93
"Orange",1879628,534833,193845,6005,22622,320699,1446,0,30083,0,0,0,30083,574700,544617,30083,574700,564916,28.97,28.45,29.58,1862010,30.34
"Placer",294233,86378,36605,2055,26,48763,145,0,9061,0,0,2,9063,96657,87594,9063,96657,95441,29.77,29.36,31.47,291479,32.74
"Plumas",13880,6471,2028,67,0,4374,10,0,0,0,0,0,0,6479,6479,0,6479,6471,46.68,46.62,46.62,13699,47.24
"Riverside",1386824,354964,8660,64548,18325,269276,0,0,8009,0,0,12,8021,368830,360809,8021,368830,362985,26.02,25.6,26.02,1372548,26.45
"Sacramento",898848,239969,89923,0,2996,147363,499,81,3203,0,0,74,3277,244139,240862,3277,244139,243246,26.8,26.7,26.96,889806,27.34
"San Benito",38015,9470,6092,0,468,3212,27,0,319,0,0,57,376,10175,9799,376,10175,9846,25.78,24.91,25.65,37685,26.13
"San Bernardino",1217280,236194,42739,23298,0,184248,291,0,0,65,465,0,0,251106,250576,530,251106,236194,20.58,19.4,19.39,1197953,19.72
"San Diego",1992145,654345,208246,0,8916,440235,1609,0,8094,0,0,0,8094,667100,659006,8094,667100,662439,33.08,32.85,33.12,1982264,33.42
"San Francisco",527743,133622,27752,4684,0,100582,1214,0,0,0,363,0,362,134595,134232,363,134595,133984,25.44,25.32,25.37,520203,25.76
"San Joaquin",389206,93988,26048,2277,0,67096,36,0,0,0,0,0,0,95457,95457,0,95457,93988,24.53,24.15,24.15,385393,24.39
"San Luis Obispo",184483,68168,16075,6684,0,45117,636,0,0,0,0,0,0,68512,68512,0,68512,68168,37.14,36.95,36.95,182701,37.31
"San Mateo",448362,135326,41151,6,2565,91724,637,0,3499,0,0,13,3512,139595,136083,3512,139595,138838,30.35,30.18,30.72,443350,31.32
"Santa Barbara",247556,73280,33973,2742,0,36789,519,0,0,0,135,0,0,74158,74023,135,74158,73280,29.9,29.6,29.59,244991,29.91
"Santa Clara",1058165,289408,116937,156,6059,167518,850,0,8157,0,0,0,8157,299677,291520,8157,299677,297565,27.55,27.35,27.91,1048723,28.37
"Santa Cruz",172642,49509,19854,2326,0,27244,440,0,1105,0,16,14,1121,50999,49864,1135,50999,50630,28.88,28.68,29.14,170535,29.69
"Shasta",116785,34178,11202,7994,0,15274,18,0,0,0,0,0,0,34488,34488,0,34488,34178,29.53,29.27,29.27,115677,29.55
"Sierra",2247,1151,0,68,0,1082,2,0,0,0,0,0,0,1152,1152,0,1152,1151,51.27,51.22,51.22,2228,51.66
"Siskiyou",28603,10753,2117,772,0,7913,18,0,0,0,0,0,0,10820,10820,0,10820,10753,37.83,37.59,37.59,27965,38.45
"Solano",273078,70002,0,16565,1,53595,151,0,0,0,0,0,0,70312,70312,0,70312,70002,25.75,25.63,25.63,269604,25.96
"Sonoma",312555,105738,36396,3423,511,65783,455,0,1435,16,21,78,1549,108118,106568,1550,108118,107287,34.1,33.83,34.16,309263,34.69
"Stanislaus",296906,76773,21985,2107,746,52627,67,0,1227,0,0,0,1227,78759,77532,1227,78759,78000,26.11,25.86,26.16,293212,26.6
"Sutter",54788,16088,5012,1154,0,9945,15,0,0,0,0,0,0,16126,16126,0,16126,16088,29.43,29.36,29.36,54210,29.68
"Tehama",37958,9583,3781,160,0,5745,9,0,0,0,0,0,0,9695,9695,0,9695,9583,25.54,25.25,25.25,37488,25.56
"Trinity",7656,2700,885,187,0,1663,10,0,0,0,0,0,0,2745,2745,0,2745,2700,35.85,35.27,35.27,7424,36.37
"Tulare",220816,48732,18297,0,0,30781,33,0,414,0,20,57,471,49602,49111,491,49602,49203,22.24,22.07,22.23,219040,22.46
"Tuolumne",35923,14017,5162,1734,0,7193,16,0,85,0,0,0,85,14190,14105,85,14190,14102,39.26,39.02,39.16,35472,39.76
"Ventura",523618,154551,85592,1491,3477,64730,527,0,5258,0,0,260,5518,161335,155817,5518,161335,160069,29.76,29.52,30.25,516989,30.96
"Yolo",120375,31194,16891,0,0,14571,152,0,586,0,0,0,586,32200,31614,586,32200,31780,26.26,25.91,26.27,118047,26.92
"Yuba",44506,10204,4140,389,0,5884,10,0,0,0,0,0,0,10423,10423,0,10423,10204,23.42,22.93,22.93,44078,23.15
